{
    "levels": [
        [
            [1, 1, 1, 1, 1, 1, 1, 1, 1, 1, 1, 1, 1, 1, 1, 1, 1, 1, 1, 1, 1, 1, 1, 1, 1, 1, 1, 1, 1, 1, 1, 1, 1, 1, 1, 1, 1],
            [1, 3, 3, 3, 2, 2, 2, 3, 3, 3, 5, 3, 3, 3, 2, 2, 2, 3, 3, 3, 5, 3, 3, 3, 2, 2, 2, 3, 3, 3, 5, 2, 3, 3, 3, 5, 1],
            [1, 3, 2, 2, 2, 2, 0, 3, 3, 3, 5, 3, 2, 2, 2, 2, 0, 3, 3, 3, 5, 3, 2, 2, 2, 2, 0, 3, 3, 3, 5, 0, 3, 3, 3, 5, 1],
            [1, 3, 2, 0, 2, 2, 2, 3, 0, 3, 5, 3, 2, 0, 2, 2, 2, 3, 0, 3, 5, 3, 2, 0, 2, 2, 2, 3, 0, 3, 5, 2, 3, 0, 3, 5, 1],
            [1, 3, 3, 3, 2, 3, 4, 4, 4, 4, 5, 3, 3, 3, 2, 3, 4, 4, 4, 4, 5, 3, 3, 3, 2, 3, 4, 4, 4, 4, 5, 4, 4, 4, 4, 5, 1],
            [1, 3, 3, 3, 3, 3, 4, 4, 4, 4, 0, 3, 3, 3, 3, 3, 4, 4, 4, 4, 0, 3, 3, 3, 3, 3, 4, 4, 4, 4, 0, 4, 4, 4, 4, 0, 1],
            [1, 3, 3, 3, 3, 3, 3, 4, 4, 4, 4, 3, 3, 3, 3, 3, 3, 4, 4, 4, 4, 3, 3, 3, 3, 3, 3, 4, 4, 4, 4, 3, 4, 4, 4, 4, 1],
            [1, 3, 2, 2, 2, 2, 0, 4, 4, 4, 3, 3, 2, 2, 2, 2, 0, 4, 4, 4, 3, 3, 2, 2, 2, 2, 0, 4, 4, 4, 3, 0, 4, 4, 4, 3, 1],
            [1, 3, 2, 2, 2, 2, 2, 4, 4, 4, 3, 3, 2, 2, 2, 2, 2, 4, 4, 4, 3, 3, 2, 2, 2, 2, 2, 4, 4, 4, 3, 2, 4, 4, 4, 3, 1],
            [1, 3, 2, 2, 2, 0, 2, 5, 0, 5, 3, 3, 2, 2, 2, 0, 2, 5, 0, 5, 3, 3, 2, 2, 2, 0, 2, 5, 0, 5, 3, 2, 5, 0, 5, 3, 1],
            [1, 3, 3, 3, 3, 3, 5, 5, 5, 5, 3, 3, 3, 3, 3, 3, 5, 5, 5, 5, 3, 3, 3, 3, 3, 3, 5, 5, 5, 5, 3, 5, 5, 5, 5, 3, 1],
            [1, 1, 1, 1, 1, 1, 1, 1, 1, 1, 1, 1, 1, 1, 1, 1, 1, 1, 1, 1, 1, 1, 1, 1, 1, 1, 1, 1, 1, 1, 1, 1, 1, 1, 1, 1, 1]

        ],
        [
            [1, 1, 1, 1, 1, 1, 1, 1, 1, 1, 1, 1, 1, 1, 1, 1, 1, 1, 1, 1, 1, 1, 1, 1, 1, 1, 1, 1, 1, 1, 1, 1, 1, 1, 1, 1, 1],
            [1, 3, 3, 3, 2, 2, 2, 3, 3, 3, 5, 3, 3, 3, 2, 2, 2, 3, 3, 3, 5, 3, 3, 3, 2, 2, 2, 3, 3, 3, 5, 2, 3, 3, 3, 5, 1],
            [1, 3, 2, 2, 2, 2, 0, 3, 3, 3, 5, 3, 2, 2, 2, 2, 0, 3, 3, 3, 5, 3, 2, 2, 2, 2, 0, 3, 3, 3, 5, 0, 3, 3, 3, 5, 1],
            [1, 3, 2, 0, 2, 2, 2, 3, 0, 3, 5, 3, 2, 0, 2, 2, 2, 3, 0, 3, 5, 3, 2, 0, 2, 2, 2, 3, 0, 3, 5, 2, 3, 0, 3, 5, 1],
            [1, 3, 3, 3, 2, 3, 4, 4, 4, 4, 5, 3, 3, 3, 2, 3, 4, 4, 4, 4, 5, 3, 3, 3, 2, 3, 4, 4, 4, 4, 5, 4, 4, 4, 4, 5, 1],
            [1, 3, 3, 3, 3, 3, 4, 4, 4, 4, 0, 3, 3, 3, 3, 3, 4, 4, 4, 4, 0, 3, 3, 3, 3, 3, 4, 4, 4, 4, 0, 4, 4, 4, 4, 0, 1],
            [1, 3, 3, 3, 3, 3, 3, 4, 4, 4, 4, 3, 3, 3, 3, 3, 3, 4, 4, 4, 4, 3, 3, 3, 3, 3, 3, 4, 4, 4, 4, 3, 4, 4, 4, 4, 1],
            [1, 3, 2, 2, 2, 2, 0, 4, 4, 4, 3, 3, 2, 2, 2, 2, 0, 4, 4, 4, 3, 3, 2, 2, 2, 2, 0, 4, 4, 4, 3, 0, 4, 4, 4, 3, 1],
            [1, 3, 2, 2, 2, 2, 2, 4, 4, 4, 3, 3, 2, 2, 2, 2, 2, 4, 4, 4, 3, 3, 2, 2, 2, 2, 2, 4, 4, 4, 3, 2, 4, 4, 4, 3, 1],
            [1, 3, 2, 2, 2, 0, 2, 5, 0, 5, 3, 3, 2, 2, 2, 0, 2, 5, 0, 5, 3, 3, 2, 2, 2, 0, 2, 5, 0, 5, 3, 2, 5, 0, 5, 3, 1],
            [1, 3, 3, 3, 3, 3, 5, 5, 5, 5, 3, 3, 3, 3, 3, 3, 5, 5, 5, 5, 3, 3, 3, 3, 3, 3, 5, 5, 5, 5, 3, 5, 5, 5, 5, 3, 1],
            [1, 1, 1, 1, 1, 1, 1, 1, 1, 1, 1, 1, 1, 1, 1, 1, 1, 1, 1, 1, 1, 1, 1, 1, 1, 1, 1, 1, 1, 1, 1, 1, 1, 1, 1, 1, 1]

        ],
        [
            [1, 1, 1, 1, 1, 1, 1, 1, 1, 1, 1, 1, 1, 1, 1, 1, 1, 1, 1, 1, 1, 1, 1, 1, 1, 1, 1, 1, 1, 1, 1, 1, 1, 1, 1, 1, 1],
            [1, 2, 2, 2, 2, 2, 2, 2, 2, 2, 2, 2, 2, 2, 2, 2, 2, 2, 2, 2, 2, 2, 2, 2, 2, 2, 2, 2, 2, 2, 2, 2, 2, 2, 2, 2, 1],
            [1, 2, 2, 2, 2, 2, 2, 2, 2, 2, 2, 2, 2, 2, 2, 2, 2, 2, 2, 2, 2, 2, 2, 2, 2, 2, 2, 2, 2, 2, 2, 2, 2, 2, 2, 2, 1],
            [1, 2, 2, 2, 2, 2, 2, 2, 2, 2, 2, 2, 2, 2, 2, 2, 2, 2, 2, 2, 2, 2, 2, 2, 2, 2, 2, 2, 2, 2, 2, 2, 2, 2, 2, 2, 1],
            [1, 2, 2, 2, 2, 2, 2, 2, 2, 2, 2, 2, 2, 2, 2, 2, 2, 2, 2, 2, 2, 2, 2, 2, 2, 2, 2, 2, 2, 2, 2, 2, 2, 2, 2, 2, 1],
            [1, 2, 2, 2, 2, 2, 2, 2, 2, 2, 2, 2, 2, 2, 2, 2, 2, 2, 2, 2, 2, 2, 2, 2, 2, 2, 2, 2, 2, 2, 2, 2, 2, 2, 2, 2, 1],
            [1, 2, 2, 2, 2, 2, 2, 2, 2, 2, 2, 2, 2, 2, 2, 2, 2, 2, 2, 2, 2, 2, 2, 2, 2, 2, 2, 2, 2, 2, 2, 2, 2, 2, 2, 2, 1],
            [1, 2, 2, 2, 2, 2, 2, 2, 2, 2, 2, 2, 2, 2, 2, 2, 2, 2, 2, 2, 2, 2, 2, 2, 2, 2, 2, 2, 2, 2, 2, 2, 2, 2, 2, 2, 1],
            [1, 2, 2, 2, 2, 2, 2, 2, 2, 2, 2, 2, 2, 2, 2, 2, 2, 2, 2, 2, 2, 2, 2, 2, 2, 2, 2, 2, 2, 2, 2, 2, 2, 2, 2, 2, 1],
            [1, 2, 2, 2, 2, 2, 2, 2, 2, 2, 2, 2, 2, 2, 2, 2, 2, 2, 2, 2, 2, 2, 2, 2, 2, 2, 2, 2, 2, 2, 2, 2, 2, 2, 2, 2, 1],
            [1, 2, 2, 2, 2, 2, 2, 2, 2, 2, 2, 2, 2, 2, 2, 2, 2, 2, 2, 2, 2, 2, 2, 2, 2, 2, 2, 2, 2, 2, 2, 2, 2, 2, 2, 2, 1],
            [1, 1, 1, 1, 1, 1, 1, 1, 1, 1, 1, 1, 1, 1, 1, 1, 1, 1, 1, 1, 1, 1, 1, 1, 1, 1, 1, 1, 1, 1, 1, 1, 1, 1, 1, 1, 1]
        ],
        [
            [1, 1, 1, 1, 1, 1, 1, 1, 1, 1, 1, 1, 1, 1, 1, 1, 1, 1, 1, 1, 1, 1, 1, 1, 1, 1, 1, 1, 1, 1, 1, 1, 1, 1, 1, 1, 1],
            [1, 2, 2, 2, 2, 2, 2, 2, 2, 2, 2, 2, 2, 2, 2, 2, 2, 2, 2, 2, 2, 2, 2, 2, 2, 2, 2, 2, 2, 2, 2, 2, 2, 2, 2, 2, 1],
            [1, 2, 2, 2, 2, 2, 2, 2, 2, 2, 2, 2, 2, 2, 2, 2, 2, 2, 2, 2, 2, 2, 2, 2, 2, 2, 2, 2, 2, 2, 2, 2, 2, 2, 2, 2, 1],
            [1, 2, 2, 2, 2, 2, 2, 2, 2, 2, 2, 2, 2, 2, 2, 2, 2, 2, 2, 2, 2, 2, 2, 2, 2, 2, 2, 2, 2, 2, 2, 2, 2, 2, 2, 2, 1],
            [1, 2, 2, 2, 2, 2, 2, 2, 2, 2, 2, 2, 2, 2, 2, 2, 2, 2, 2, 2, 2, 2, 2, 2, 2, 2, 2, 2, 2, 2, 2, 2, 2, 2, 2, 2, 1],
            [1, 2, 2, 2, 2, 2, 2, 2, 2, 2, 2, 2, 2, 2, 2, 2, 2, 2, 2, 2, 2, 2, 2, 2, 2, 2, 2, 2, 2, 2, 2, 2, 2, 2, 2, 2, 1],
            [1, 2, 2, 2, 2, 2, 2, 2, 2, 2, 2, 2, 2, 2, 2, 2, 2, 2, 2, 2, 2, 2, 2, 2, 2, 2, 2, 2, 2, 2, 2, 2, 2, 2, 2, 2, 1],
            [1, 2, 2, 2, 2, 2, 2, 2, 2, 2, 2, 2, 2, 2, 2, 2, 2, 2, 2, 2, 2, 2, 2, 2, 2, 2, 2, 2, 2, 2, 2, 2, 2, 2, 2, 2, 1],
            [1, 2, 2, 2, 2, 2, 2, 2, 2, 2, 2, 2, 2, 2, 2, 2, 2, 2, 2, 2, 2, 2, 2, 2, 2, 2, 2, 2, 2, 2, 2, 2, 2, 2, 2, 2, 1],
            [1, 2, 2, 2, 2, 2, 2, 2, 2, 2, 2, 2, 2, 2, 2, 2, 2, 2, 2, 2, 2, 2, 2, 2, 2, 2, 2, 2, 2, 2, 2, 2, 2, 2, 2, 2, 1],
            [1, 2, 2, 2, 2, 2, 2, 2, 2, 2, 2, 2, 2, 2, 2, 2, 2, 2, 2, 2, 2, 2, 2, 2, 2, 2, 2, 2, 2, 2, 2, 2, 2, 2, 2, 2, 1],
            [1, 1, 1, 1, 1, 1, 1, 1, 1, 1, 1, 1, 1, 1, 1, 1, 1, 1, 1, 1, 1, 1, 1, 1, 1, 1, 1, 1, 1, 1, 1, 1, 1, 1, 1, 1, 1]
        ],
        [
            [1, 1, 1, 1, 1, 1, 1, 1, 1, 1, 1, 1, 1, 1, 1, 1, 1, 1, 1, 1, 1, 1, 1, 1, 1, 1, 1, 1, 1, 1, 1, 1, 1, 1, 1, 1, 1],
            [1, 1337, 420, 69, 5, 4, 3, 4, 5, 69, 420, 1337, 2, 1337, 420, 69, 5, 4, 3, 4, 5, 69, 420, 1337, 2, 1337, 420, 69, 5, 4, 3, 4, 5, 69, 420, 1337, 1],
            [1, 1337, 420, 69, 5, 4, 3, 4, 5, 69, 420, 1337, 2, 1337, 420, 69, 5, 4, 3, 4, 5, 69, 420, 1337, 2, 1337, 420, 69, 5, 4, 3, 4, 5, 69, 420, 1337, 1],
            [1, 1337, 420, 69, 5, 4, 3, 4, 5, 69, 420, 1337, 2, 1337, 420, 69, 5, 4, 3, 4, 5, 69, 420, 1337, 2, 1337, 420, 69, 5, 4, 3, 4, 5, 69, 420, 1337, 1],
            [1, 1337, 420, 69, 5, 4, 3, 4, 5, 69, 420, 1337, 2, 1337, 420, 69, 5, 4, 3, 4, 5, 69, 420, 1337, 2, 1337, 420, 69, 5, 4, 3, 4, 5, 69, 420, 1337, 1],
            [1, 0, 0, 0, 0, 0, 0, 0, 0, 0, 0, 0, 0, 0, 0, 0, 0, 0, 0, 0, 0, 0, 0, 0, 0, 0, 0, 0, 0, 0, 0, 0, 0, 0, 0, 0, 1],
            [1, 0, 0, 0, 0, 0, 0, 0, 0, 0, 0, 0, 0, 0, 0, 0, 0, 0, 0, 0, 0, 0, 0, 0, 0, 0, 0, 0, 0, 0, 0, 0, 0, 0, 0, 0, 1],
            [1, 1337, 420, 69, 5, 4, 3, 4, 5, 69, 420, 1337, 2, 1337, 420, 69, 5, 4, 3, 4, 5, 69, 420, 1337, 2, 1337, 420, 69, 5, 4, 3, 4, 5, 69, 420, 1337, 1],
            [1, 1337, 420, 69, 5, 4, 3, 4, 5, 69, 420, 1337, 2, 1337, 420, 69, 5, 4, 3, 4, 5, 69, 420, 1337, 2, 1337, 420, 69, 5, 4, 3, 4, 5, 69, 420, 1337, 1],
            [1, 1337, 420, 69, 5, 4, 3, 4, 5, 69, 420, 1337, 2, 1337, 420, 69, 5, 4, 3, 4, 5, 69, 420, 1337, 2, 1337, 420, 69, 5, 4, 3, 4, 5, 69, 420, 1337, 1],
            [1, 1337, 420, 69, 5, 4, 3, 4, 5, 69, 420, 1337, 2, 1337, 420, 69, 5, 4, 3, 4, 5, 69, 420, 1337, 2, 1337, 420, 69, 5, 4, 3, 4, 5, 69, 420, 1337, 1],
            [1, 1, 1, 1, 1, 1, 1, 1, 1, 1, 1, 1, 1, 1, 1, 1, 1, 1, 1, 1, 1, 1, 1, 1, 1, 1, 1, 1, 1, 1, 1, 1, 1, 1, 1, 1, 1]
        ],
        [
            [1, 1, 1, 1, 1, 1, 1, 1, 1, 1, 1, 1, 1, 1, 1, 1, 1, 1, 1, 1, 1, 1, 1, 1, 1, 1, 1, 1, 1, 1, 1, 1, 1, 1, 1, 1, 1],
            [1, 1337, 420, 69, 5, 4, 3, 4, 5, 69, 420, 1337, 2, 1337, 420, 69, 5, 4, 3, 4, 5, 69, 420, 1337, 2, 1337, 420, 69, 5, 4, 3, 4, 5, 69, 420, 1337, 1],
            [1, 1337, 420, 69, 5, 4, 3, 4, 5, 69, 420, 1337, 2, 1337, 420, 69, 5, 4, 3, 4, 5, 69, 420, 1337, 2, 1337, 420, 69, 5, 4, 3, 4, 5, 69, 420, 1337, 1],
            [1, 1337, 420, 69, 5, 4, 3, 4, 5, 69, 420, 1337, 2, 1337, 420, 69, 5, 4, 3, 4, 5, 69, 420, 1337, 2, 1337, 420, 69, 5, 4, 3, 4, 5, 69, 420, 1337, 1],
            [1, 1337, 420, 69, 5, 4, 3, 4, 5, 69, 420, 1337, 2, 1337, 420, 69, 5, 4, 3, 4, 5, 69, 420, 1337, 2, 1337, 420, 69, 5, 4, 3, 4, 5, 69, 420, 1337, 1],
            [1, 0, 0, 0, 0, 0, 0, 0, 0, 0, 0, 0, 0, 0, 0, 0, 0, 0, 0, 0, 0, 0, 0, 0, 0, 0, 0, 0, 0, 0, 0, 0, 0, 0, 0, 0, 1],
            [1, 0, 0, 0, 0, 0, 0, 0, 0, 0, 0, 0, 0, 0, 0, 0, 0, 0, 0, 0, 0, 0, 0, 0, 0, 0, 0, 0, 0, 0, 0, 0, 0, 0, 0, 0, 1],
            [1, 1337, 420, 69, 5, 4, 3, 4, 5, 69, 420, 1337, 2, 1337, 420, 69, 5, 4, 3, 4, 5, 69, 420, 1337, 2, 1337, 420, 69, 5, 4, 3, 4, 5, 69, 420, 1337, 1],
            [1, 1337, 420, 69, 5, 4, 3, 4, 5, 69, 420, 1337, 2, 1337, 420, 69, 5, 4, 3, 4, 5, 69, 420, 1337, 2, 1337, 420, 69, 5, 4, 3, 4, 5, 69, 420, 1337, 1],
            [1, 1337, 420, 69, 5, 4, 3, 4, 5, 69, 420, 1337, 2, 1337, 420, 69, 5, 4, 3, 4, 5, 69, 420, 1337, 2, 1337, 420, 69, 5, 4, 3, 4, 5, 69, 420, 1337, 1],
            [1, 1337, 420, 69, 5, 4, 3, 4, 5, 69, 420, 1337, 2, 1337, 420, 69, 5, 4, 3, 4, 5, 69, 420, 1337, 2, 1337, 420, 69, 5, 4, 3, 4, 5, 69, 420, 1337, 1],
            [1, 1, 1, 1, 1, 1, 1, 1, 1, 1, 1, 1, 1, 1, 1, 1, 1, 1, 1, 1, 1, 1, 1, 1, 1, 1, 1, 1, 1, 1, 1, 1, 1, 1, 1, 1, 1]
        ]
    ],
    "objects": [
        {
            "tileIdX": 0,
            "tileIdY": 1,
            "tileIdZ": 2,
            "meshId": 1337,
            "materialId": 69
        },
        {
            "tileIdX": 3,
            "tileIdY": 4,
            "tileIdZ": 5,
            "meshId": 1337,
            "materialId": 420
        },
        {
            "tileIdX": 6,
            "tileIdY": 7,
            "tileIdZ": 8,
            "meshId": 1337,
            "materialId": 5
        },
        {
            "tileIdX": 9,
            "tileIdY": 10,
            "tileIdZ": 11,
            "meshId": 1337,
            "materialId": 15
        },
        {
            "tileIdX": 12,
            "tileIdY": 13,
            "tileIdZ": 14,
            "meshId": 1337,
            "materialId": 8
        }
    ],
    "stairs": [
        [3, 0, 2],
        [10, 0, 10],
        [5, 2, 10]
    ]
}