{
    "levels": [
        [
            [ 1,  1,  1,  1,  1,  1,  1,  1,  1,  1,  1,  1,  1,  1,  1,  1,  1,  1,  1,  1,  1,  1,  1,  1,  1,  1,  1,  1,  1,  1,  1,  1,  1,  1,  1,  1,  1,  1,  1,  1,  1, 1],
            [ 1, 16, 16, 16, 16, 16,  0, 17, 17, 17, 17, 17, 17, 18, 18, 18, 18,  0, 19, 19, 19, 19, 19, 20, 20, 20, 20, 20,  0, 21, 21, 21, 21, 22, 22, 22, 22,  0, 23, 23, 24, 1],
            [ 1, 16, 16, 16, 16, 16, 16, 17, 17, 17, 17, 17, 17, 18, 18, 18, 18, 18, 19, 19, 19, 19, 19, 20, 20, 20, 20, 20, 20, 21, 21, 21, 21, 22, 22, 22, 22, 22, 23, 23, 24, 1],
            [ 1, 16, 16, 16, 16, 16, 16, 17, 17, 17, 17, 17, 17, 18, 18, 18, 18, 18, 19, 19, 19, 19, 19, 20, 20, 20, 20, 20, 20, 21, 21, 21, 21, 22, 22, 22, 22, 22, 23, 23, 24, 1],
            [ 1, 16, 16, 16, 16, 16, 16, 17, 17, 17, 17, 17, 17, 18, 18, 18, 18, 18, 19, 19, 19, 19, 19, 20, 20, 20, 20, 20, 20, 21, 21, 21, 21, 22, 22, 22, 22, 22, 23, 23, 24, 1],
            [ 1, 16, 16, 16, 16, 16, 16, 17, 17, 17, 17, 17, 17, 18, 18, 18, 18, 18, 19, 19, 19, 19, 19, 20, 20, 20, 20, 20, 20, 21, 21, 21, 21, 22, 22, 22, 22, 22, 23, 23, 24, 1],
            [ 1, 16, 16, 16, 16, 16, 16, 17, 17, 17, 17, 17, 17, 18, 18, 18, 18, 18, 19, 19, 19, 19, 19, 20, 20, 20, 20, 20, 20, 21, 21, 21, 21, 22, 22, 22, 22, 22, 23, 23, 24, 1],
            [ 1, 16, 16, 16, 16, 16, 16, 17, 17, 17, 17, 17, 17, 18, 18, 18, 18, 18, 19, 19, 19, 19, 19, 20, 20, 20, 20, 20, 20, 21, 21, 21, 21, 22, 22, 22, 22, 22, 23, 23, 24, 1],
            [ 1, 16, 16, 16, 16, 16, 16, 17, 17, 17, 17, 17, 17, 18, 18, 18, 18, 18, 19, 19, 19, 19, 19, 20, 20, 20, 20, 20, 20, 21, 21, 21, 21, 22, 22, 22, 22, 22, 23, 23, 24, 1],
            [ 1, 16, 16, 16, 16, 16, 16, 17, 17, 17, 17, 17, 17, 18, 18, 18, 18, 18, 19, 19, 19, 19, 19, 20, 20, 20, 20, 20, 20, 21, 21, 21, 21, 22, 22, 22, 22, 22, 23, 23, 24, 1],
            [ 1, 16, 16, 16, 16, 16, 16, 17, 17, 17, 17, 17,  0, 18, 18, 18, 18, 18, 19, 19, 19, 19,  0, 20, 20, 20, 20, 20, 20, 21, 21, 21,  0, 22, 22, 22, 22, 22, 23,  0, 24, 1],
            [ 1,  1,  1,  1,  1,  1,  1,  1,  1,  1,  1,  1,  1,  1,  1,  1,  1,  1,  1,  1,  1,  1,  1,  1,  1,  1,  1,  1,  1,  1,  1,  1,  1,  1,  1,  1,  1,  1,  1,  1,  1, 1]
        ],
        [
            [ 1,  1,  1,  1,  1,  1,  1,  1,  1,  1,  1,  1,  1,  1,  1,  1,  1,  1,  1,  1,  1,  1,  1,  1,  1,  1,  1,  1,  1,  1,  1,  1,  1,  1,  1,  1,  1,  1,  1,  1,  1, 1],
            [ 1, 16, 16, 16, 16, 16,  0, 17, 17, 17, 17, 17, 17, 18, 18, 18, 18,  0, 19, 19, 19, 19, 19, 20, 20, 20, 20, 20,  0, 21, 21, 21, 21, 22, 22, 22, 22,  0, 23, 23, 24, 1],
            [ 1, 16, 16, 16, 16, 16, 16, 17, 17, 17, 17, 17, 17, 18, 18, 18, 18, 18, 19, 19, 19, 19, 19, 20, 20, 20, 20, 20, 20, 21, 21, 21, 21, 22, 22, 22, 22, 22, 23, 23, 24, 1],
            [ 1, 16, 16, 16, 16, 16, 16, 17, 17, 17, 17, 17, 17, 18, 18, 18, 18, 18, 19, 19, 19, 19, 19, 20, 20, 20, 20, 20, 20, 21, 21, 21, 21, 22, 22, 22, 22, 22, 23, 23, 24, 1],
            [ 1, 16, 16, 16, 16, 16, 16, 17, 17, 17, 17, 17, 17, 18, 18, 18, 18, 18, 19, 19, 19, 19, 19, 20, 20, 20, 20, 20, 20, 21, 21, 21, 21, 22, 22, 22, 22, 22, 23, 23, 24, 1],
            [ 1, 16, 16, 16, 16, 16, 16, 17, 17, 17, 17, 17, 17, 18, 18, 18, 18, 18, 19, 19, 19, 19, 19, 20, 20, 20, 20, 20, 20, 21, 21, 21, 21, 22, 22, 22, 22, 22, 23, 23, 24, 1],
            [ 1, 16, 16, 16, 16, 16, 16, 17, 17, 17, 17, 17, 17, 18, 18, 18, 18, 18, 19, 19, 19, 19, 19, 20, 20, 20, 20, 20, 20, 21, 21, 21, 21, 22, 22, 22, 22, 22, 23, 23, 24, 1],
            [ 1, 16, 16, 16, 16, 16, 16, 17, 17, 17, 17, 17, 17, 18, 18, 18, 18, 18, 19, 19, 19, 19, 19, 20, 20, 20, 20, 20, 20, 21, 21, 21, 21, 22, 22, 22, 22, 22, 23, 23, 24, 1],
            [ 1, 16, 16, 16, 16, 16, 16, 17, 17, 17, 17, 17, 17, 18, 18, 18, 18, 18, 19, 19, 19, 19, 19, 20, 20, 20, 20, 20, 20, 21, 21, 21, 21, 22, 22, 22, 22, 22, 23, 23, 24, 1],
            [ 1, 16, 16, 16, 16, 16, 16, 17, 17, 17, 17, 17, 17, 18, 18, 18, 18, 18, 19, 19, 19, 19, 19, 20, 20, 20, 20, 20, 20, 21, 21, 21, 21, 22, 22, 22, 22, 22, 23, 23, 24, 1],
            [ 1, 16, 16, 16, 16, 16, 16, 17, 17, 17, 17, 17,  0, 18, 18, 18, 18, 18, 19, 19, 19, 19,  0, 20, 20, 20, 20, 20, 20, 21, 21, 21,  0, 22, 22, 22, 22, 22, 23,  0, 24, 1],
            [ 1,  1,  1,  1,  1,  1,  1,  1,  1,  1,  1,  1,  1,  1,  1,  1,  1,  1,  1,  1,  1,  1,  1,  1,  1,  1,  1,  1,  1,  1,  1,  1,  1,  1,  1,  1,  1,  1,  1,  1,  1, 1]
        ],
        [
            [ 1,  1,  1,  1,  1,  1,  1,  1,  1,  1,  1,  1,  1,  1,  1,  1,  1,  1,  1,  1,  1,  1,  1,  1,  1,  1,  1,  1,  1,  1,  1,  1,  1,  1,  1,  1,  1,  1,  1,  1,  1, 1],
            [ 1, 15, 15, 15, 15, 15, 15, 15, 15, 15, 15, 15, 15, 15, 15, 15, 15, 15, 15, 15, 15, 15, 15, 15, 15, 15, 15, 15, 15, 15, 15, 15, 15, 15, 15, 15, 15, 15, 15, 15, 15, 1],
            [ 1, 15, 15, 15, 15, 15, 15, 15, 15, 15, 15, 15, 15, 15, 15, 15, 15, 15, 15, 15, 15, 15, 15, 15, 15, 15, 15, 15, 15, 15, 15, 15, 15, 15, 15, 15, 15, 15, 15, 15, 15, 1],
            [ 1, 15, 15, 11, 11, 11, 11, 11, 11, 11, 15, 15, 12, 12, 12, 12, 12, 12, 12, 15, 15, 13, 13, 13, 13, 13, 13, 13, 15, 15, 14, 14, 14, 14, 14, 14, 14, 15, 15, 15, 15, 1],
            [ 1, 15, 15, 11, 11, 11, 11, 11, 11, 11, 15, 15, 12, 12, 12, 12, 12, 12, 12, 15, 15, 13, 13, 13, 13, 13, 13, 13, 15, 15, 14, 14, 14, 14, 14, 14, 14, 15, 15, 15, 15, 1],
            [ 1, 15, 15,  0, 11, 11, 11, 11, 11,  0, 15, 15,  0, 12, 12, 12, 12, 12,  0, 15, 15,  0, 13, 13, 13, 13, 13,  0, 15, 15,  0, 14, 14, 14, 14, 14, 14, 15, 15, 15, 15, 1],
            [ 1, 15, 15,  0, 11, 11, 11, 11, 11,  0, 15, 15,  0, 12, 12, 12, 12, 12,  0, 15, 15,  0, 13, 13, 13, 13, 13,  0, 15, 15,  0, 14, 14, 14, 14, 14, 14, 15, 15, 15, 15, 1],
            [ 1, 15, 15, 11, 11, 11, 11, 11, 11, 11, 15, 15, 12, 12, 12, 12, 12, 12, 12, 15, 15, 13, 13, 13, 13, 13, 13, 13, 15, 15, 14, 14, 14, 14, 14, 14, 14, 15, 15, 15, 15, 1],
            [ 1, 15, 15, 11, 11, 11, 11, 11, 11, 11, 15, 15, 12, 12, 12, 12, 12, 12, 12, 15, 15, 13, 13, 13, 13, 13, 13, 13, 15, 15, 14, 14, 14, 14, 14, 14, 14, 15, 15, 15, 15, 1],
            [ 1, 15, 15, 15, 15, 15, 15, 15, 15, 15, 15, 15, 15, 15, 15, 15, 15, 15, 15, 15, 15, 15, 15, 15, 15, 15, 15, 15, 15, 15, 15, 15, 15, 15, 15, 15, 15, 15, 15, 15, 15, 1],
            [ 1, 15, 15, 15, 15, 15, 15, 15, 15, 15, 15, 15, 15, 15, 15, 15, 15, 15, 15, 15, 15, 15, 15, 15, 15, 15, 15, 15, 15, 15, 15, 15, 15, 15, 15, 15, 15, 15, 15, 15, 15, 1],
            [ 1,  1,  1,  1,  1,  1,  1,  1,  1,  1,  1,  1,  1,  1,  1,  1,  1,  1,  1,  1,  1,  1,  1,  1,  1,  1,  1,  1,  1,  1,  1,  1,  1,  1,  1,  1,  1,  1,  1,  1,  1, 1]
        ],
        [
            [ 1,  1,  1,  1,  1,  1,  1,  1,  1,  1,  1,  1,  1,  1,  1,  1,  1,  1,  1,  1,  1,  1,  1,  1,  1,  1,  1,  1,  1,  1,  1,  1,  1,  1,  1,  1,  1,  1,  1,  1,  1, 1],
            [ 1, 15, 15, 15, 15, 15, 15, 15, 15, 15, 15, 15, 15, 15, 15, 15, 15, 15, 15, 15, 15, 15, 15, 15, 15, 15, 15, 15, 15, 15, 15, 15, 15, 15, 15, 15, 15, 15, 15, 15, 15, 1],
            [ 1, 15, 15, 15, 15, 15, 15, 15, 15, 15, 15, 15, 15, 15, 15, 15, 15, 15, 15, 15, 15, 15, 15, 15, 15, 15, 15, 15, 15, 15, 15, 15, 15, 15, 15, 15, 15, 15, 15, 15, 15, 1],
            [ 1, 15, 15, 11, 11, 11, 11, 11, 11, 11, 15, 15, 12, 12, 12, 12, 12, 12, 12, 15, 15, 13, 13, 13, 13, 13, 13, 13, 15, 15, 14, 14, 14, 14, 14, 14, 14, 15, 15, 15, 15, 1],
            [ 1, 15, 15, 11, 11, 11, 11, 11, 11, 11, 15, 15, 12, 12, 12, 12, 12, 12, 12, 15, 15, 13, 13, 13, 13, 13, 13, 13, 15, 15, 14, 14, 14, 14, 14, 14, 14, 15, 15, 15, 15, 1],
            [ 1, 15, 15,  0, 11, 11, 11, 11, 11,  0, 15, 15,  0, 12, 12, 12, 12, 12,  0, 15, 15,  0, 13, 13, 13, 13, 13,  0, 15, 15,  0, 14, 14, 14, 14, 14, 14, 15, 15, 15, 15, 1],
            [ 1, 15, 15,  0, 11, 11, 11, 11, 11,  0, 15, 15,  0, 12, 12, 12, 12, 12,  0, 15, 15,  0, 13, 13, 13, 13, 13,  0, 15, 15,  0, 14, 14, 14, 14, 14, 14, 15, 15, 15, 15, 1],
            [ 1, 15, 15, 11, 11, 11, 11, 11, 11, 11, 15, 15, 12, 12, 12, 12, 12, 12, 12, 15, 15, 13, 13, 13, 13, 13, 13, 13, 15, 15, 14, 14, 14, 14, 14, 14, 14, 15, 15, 15, 15, 1],
            [ 1, 15, 15, 11, 11, 11, 11, 11, 11, 11, 15, 15, 12, 12, 12, 12, 12, 12, 12, 15, 15, 13, 13, 13, 13, 13, 13, 13, 15, 15, 14, 14, 14, 14, 14, 14, 14, 15, 15, 15, 15, 1],
            [ 1, 15, 15, 15, 15, 15, 15, 15, 15, 15, 15, 15, 15, 15, 15, 15, 15, 15, 15, 15, 15, 15, 15, 15, 15, 15, 15, 15, 15, 15, 15, 15, 15, 15, 15, 15, 15, 15, 15, 15, 15, 1],
            [ 1, 15, 15, 15, 15, 15, 15, 15, 15, 15, 15, 15, 15, 15, 15, 15, 15, 15, 15, 15, 15, 15, 15, 15, 15, 15, 15, 15, 15, 15, 15, 15, 15, 15, 15, 15, 15, 15, 15, 15, 15, 1],
            [ 1,  1,  1,  1,  1,  1,  1,  1,  1,  1,  1,  1,  1,  1,  1,  1,  1,  1,  1,  1,  1,  1,  1,  1,  1,  1,  1,  1,  1,  1,  1,  1,  1,  1,  1,  1,  1,  1,  1,  1,  1, 1]
        ],
        [
            [ 1,  1,  1,  1,  1,  1,  1,  1,  1,  1,  1,  1,  1,  1,  1,  1,  1,  1,  1,  1,  1,  1,  1,  1,  1,  1,  1,  1,  1,  1,  1,  1,  1,  1,  1,  1,  1,  1,  1,  1,  1, 1],
            [ 1,  2,  2,  2,  2,  2,  2,  4,  4,  4,  4,  4,  4,  4,  4,  4,  4,  4,  4,  6,  6,  6,  6,  6,  6,  6,  6,  6,  6,  6,  6,  8,  8,  8,  8,  8,  0,  7,  7,  7,  7, 1],
            [ 1,  2,  2,  2,  2,  2,  2,  4,  4,  4,  4,  4,  4,  4,  4,  4,  4,  4,  4,  6,  6,  6,  6,  6,  6,  6,  6,  6,  6,  6,  6,  8,  8,  8,  8,  8,  0,  7,  7,  7,  7, 1],
            [ 1,  2,  2,  2,  2,  2,  0,  4,  4,  4,  4,  4,  4,  4,  4,  4,  4,  4,  4,  6,  6,  6,  6,  6,  6,  6,  6,  6,  6,  6,  6,  8,  8,  8,  8,  8,  0,  7,  7,  7,  7, 1],
            [ 1,  2,  2,  2,  2,  2,  2,  4,  4,  4,  4,  4,  4,  4,  4,  4,  4,  4,  4,  6,  6,  6,  6,  6,  6,  6,  6,  6,  6,  6,  6,  8,  8,  8,  8,  8,  0,  7,  7,  7,  7, 1],
            [ 1,  2,  2,  2,  2,  2,  2,  4,  4,  4,  4,  4,  4,  4,  4,  4,  4,  4,  4,  6,  6,  6,  6,  6,  6,  6,  6,  6,  6,  0,  6,  8,  8,  8,  8,  8,  0,  7,  7,  7,  7, 1],
            [ 1,  2,  2,  2,  2,  2,  2,  3,  3,  3,  3,  3,  3,  3,  3,  3,  5,  5,  0,  5,  5,  5,  5,  5,  0,  5,  5,  5,  9,  9,  9,  8,  8,  8,  0,  8,  0,  7,  7,  7,  7, 1],
            [ 1,  2,  2,  2,  2,  2,  2,  3,  3,  3,  3,  3,  3,  3,  3,  3,  5,  5,  5,  5,  5,  5,  5,  5,  5,  5,  5,  5,  9,  9,  9, 10, 10, 10, 10, 10,  7,  7,  7,  7,  7, 1],
            [ 1,  2,  2,  2,  2,  2,  0,  3,  3,  3,  3,  3,  3,  3,  3,  3,  0,  5,  5,  5,  5,  5,  5,  5,  5,  5,  5,  5,  9,  9,  9, 10, 10, 10, 10, 10,  7,  7,  7,  7,  7, 1],
            [ 1,  2,  2,  2,  2,  2,  2,  3,  3,  3,  3,  3,  3,  3,  3,  3,  5,  5,  5,  5,  5,  5,  5,  5,  5,  5,  5,  5,  9,  9,  9,  0, 10, 10, 10, 10,  7,  7,  7,  7,  7, 1],
            [ 1,  2,  2,  2,  2,  2,  2,  3,  3,  3,  3,  3,  3,  3,  3,  3,  5,  5,  5,  5,  5,  5,  5,  5,  5,  5,  5,  5,  9,  9,  9, 10, 10, 10, 10, 10,  7,  7,  7,  7,  7, 1],
            [ 1,  1,  1,  1,  1,  1,  1,  1,  1,  1,  1,  1,  1,  1,  1,  1,  1,  1,  1,  1,  1,  1,  1,  1,  1,  1,  1,  1,  1,  1,  1,  1,  1,  1,  1,  1,  1,  1,  1,  1,  1, 1]
        ],
        [
            [ 1,  1,  1,  1,  1,  1,  1,  1,  1,  1,  1,  1,  1,  1,  1,  1,  1,  1,  1,  1,  1,  1,  1,  1,  1,  1,  1,  1,  1,  1,  1,  1,  1,  1,  1,  1,  1,  1,  1,  1,  1, 1],
            [ 1,  2,  2,  2,  2,  2,  2,  4,  4,  4,  4,  4,  4,  4,  4,  4,  4,  4,  4,  6,  6,  6,  6,  6,  6,  6,  6,  6,  6,  6,  6,  8,  8,  8,  8,  8,  0,  7,  7,  7,  7, 1],
            [ 1,  2,  2,  2,  2,  2,  2,  4,  4,  4,  4,  4,  4,  4,  4,  4,  4,  4,  4,  6,  6,  6,  6,  6,  6,  6,  6,  6,  6,  6,  6,  8,  8,  8,  8,  8,  0,  7,  7,  7,  7, 1],
            [ 1,  2,  2,  2,  2,  2,  0,  4,  4,  4,  4,  4,  4,  4,  4,  4,  4,  4,  4,  6,  6,  6,  6,  6,  6,  6,  6,  6,  6,  6,  6,  8,  8,  8,  8,  8,  0,  7,  7,  7,  7, 1],
            [ 1,  2,  2,  2,  2,  2,  2,  4,  4,  4,  4,  4,  4,  4,  4,  4,  4,  4,  4,  6,  6,  6,  6,  6,  6,  6,  6,  6,  6,  6,  6,  8,  8,  8,  8,  8,  0,  7,  7,  7,  7, 1],
            [ 1,  2,  2,  2,  2,  2,  2,  4,  4,  4,  4,  4,  4,  4,  4,  4,  4,  4,  4,  6,  6,  6,  6,  6,  6,  6,  6,  6,  6,  0,  6,  8,  8,  8,  8,  8,  0,  7,  7,  7,  7, 1],
            [ 1,  2,  2,  2,  2,  2,  2,  3,  3,  3,  3,  3,  3,  3,  3,  3,  5,  5,  0,  5,  5,  5,  5,  5,  0,  5,  5,  5,  9,  9,  9,  8,  8,  8,  0,  8,  0,  7,  7,  7,  7, 1],
            [ 1,  2,  2,  2,  2,  2,  2,  3,  3,  3,  3,  3,  3,  3,  3,  3,  5,  5,  5,  5,  5,  5,  5,  5,  5,  5,  5,  5,  9,  9,  9, 10, 10, 10, 10, 10,  7,  7,  7,  7,  7, 1],
            [ 1,  2,  2,  2,  2,  2,  0,  3,  3,  3,  3,  3,  3,  3,  3,  3,  0,  5,  5,  5,  5,  5,  5,  5,  5,  5,  5,  5,  9,  9,  9, 10, 10, 10, 10, 10,  7,  7,  7,  7,  7, 1],
            [ 1,  2,  2,  2,  2,  2,  2,  3,  3,  3,  3,  3,  3,  3,  3,  3,  5,  5,  5,  5,  5,  5,  5,  5,  5,  5,  5,  5,  9,  9,  9,  0, 10, 10, 10, 10,  7,  7,  7,  7,  7, 1],
            [ 1,  2,  2,  2,  2,  2,  2,  3,  3,  3,  3,  3,  3,  3,  3,  3,  5,  5,  5,  5,  5,  5,  5,  5,  5,  5,  5,  5,  9,  9,  9, 10, 10, 10, 10, 10,  7,  7,  7,  7,  7, 1],
            [ 1,  1,  1,  1,  1,  1,  1,  1,  1,  1,  1,  1,  1,  1,  1,  1,  1,  1,  1,  1,  1,  1,  1,  1,  1,  1,  1,  1,  1,  1,  1,  1,  1,  1,  1,  1,  1,  1,  1,  1,  1, 1]
        ]
    ],
    "objects": [
        {
            "tileIdX": 7,
            "tileIdY": 0,
            "tileIdZ": 22,
            "gameObject": 0,
            "rotation": 0.0
        },
        {
            "tileIdX": 9,
            "tileIdY": 4,
            "tileIdZ": 0,
            "gameObject": 1,
            "rotation": 1.5707963705062867
        },
        {
            "tileIdX": 0,
            "tileIdY": 4,
            "tileIdZ": 0,
            "gameObject": 2,
            "rotation": 4.71238899230957
        },
        {
            "tileIdX": 4,
            "tileIdY": 4,
            "tileIdZ": 0,
            "gameObject": 0,
            "rotation": 4.71238899230957
        },
        {
            "tileIdX": 5,
            "tileIdY": 4,
            "tileIdZ": 0,
            "gameObject": 0,
            "rotation": 1.5707963705062867
        },
        {
            "tileIdX": 5,
            "tileIdY": 4,
            "tileIdZ": 5,
            "gameObject": 3,
            "rotation": 7.853981971740723
        },
        {
            "tileIdX": 4,
            "tileIdY": 4,
            "tileIdZ": 5,
            "gameObject": 4,
            "rotation": 7.853981971740723
        },
        {
            "tileIdX": 3,
            "tileIdY": 4,
            "tileIdZ": 0,
            "gameObject": 5,
            "rotation": 4.71238899230957
        },
        {
            "tileIdX": 6,
            "tileIdY": 4,
            "tileIdZ": 0,
            "gameObject": 5,
            "rotation": 4.71238899230957
        },
        {
            "tileIdX": 5,
            "tileIdY": 0,
            "tileIdZ": 20,
            "gameObject": 1,
            "rotation": 0.0
        },
        {
            "tileIdX": 5,
            "tileIdY": 0,
            "tileIdZ": 20,
            "gameObject": 1,
            "rotation": 0.0
        },
        {
            "tileIdX": 5,
            "tileIdY": 0,
            "tileIdZ": 20,
            "gameObject": 0,
            "rotation": 0.0
        },
        {
            "tileIdX": 5,
            "tileIdY": 0,
            "tileIdZ": 20,
            "gameObject": 1,
            "rotation": 0.0
        },
        {
            "tileIdX": 5,
            "tileIdY": 0,
            "tileIdZ": 20,
            "gameObject": 1,
            "rotation": 0.0
        },
        {
            "tileIdX": 5,
            "tileIdY": 0,
            "tileIdZ": 20,
            "gameObject": 1,
            "rotation": 0.0
        },
        {
            "tileIdX": 5,
            "tileIdY": 0,
            "tileIdZ": 20,
            "gameObject": 1,
            "rotation": 0.0
        },
        {
            "tileIdX": 5,
            "tileIdY": 0,
            "tileIdZ": 20,
            "gameObject": 1,
            "rotation": 0.0
        },
        {
            "tileIdX": 5,
            "tileIdY": 0,
            "tileIdZ": 20,
            "gameObject": 1,
            "rotation": 0.0
        },
        {
            "tileIdX": 5,
            "tileIdY": 0,
            "tileIdZ": 20,
            "gameObject": 1,
            "rotation": 0.0
        },
        {
            "tileIdX": 5,
            "tileIdY": 0,
            "tileIdZ": 20,
            "gameObject": 1,
            "rotation": 0.0
        },
        {
            "tileIdX": 5,
            "tileIdY": 0,
            "tileIdZ": 20,
            "gameObject": 1,
            "rotation": 0.0
        },
        {
            "tileIdX": 5,
            "tileIdY": 0,
            "tileIdZ": 20,
            "gameObject": 1,
            "rotation": 0.0
        },
        {
            "tileIdX": 5,
            "tileIdY": 0,
            "tileIdZ": 20,
            "gameObject": 1,
            "rotation": 0.0
        },
        {
            "tileIdX": 5,
            "tileIdY": 0,
            "tileIdZ": 20,
            "gameObject": 1,
            "rotation": 0.0
        },
        {
            "tileIdX": 5,
            "tileIdY": 0,
            "tileIdZ": 20,
            "gameObject": 1,
            "rotation": 0.0
        },
        {
            "tileIdX": 5,
            "tileIdY": 0,
            "tileIdZ": 20,
            "gameObject": 1,
            "rotation": 0.0
        },
        {
            "tileIdX": 5,
            "tileIdY": 0,
            "tileIdZ": 20,
            "gameObject": 1,
            "rotation": 0.0
        },
        {
            "tileIdX": 5,
            "tileIdY": 0,
            "tileIdZ": 20,
            "gameObject": 1,
            "rotation": 0.0
        },
        {
            "tileIdX": 5,
            "tileIdY": 0,
            "tileIdZ": 20,
            "gameObject": 1,
            "rotation": 0.0
        }
    ],
    "stairs": [
        [
            6, 0, 40
        ],
        [
            5, 2, 40
        ]
    ]
}